11111111111111111111
10000000000000000001
10111111000000000001
10000001000000000001
10000001000000000001
10000000000000000001
10000000000000000001
10000000000011000001
10000000000011000001
10000000000000000001
10000000000000000001
10000000110000000001
10000011100000000001
10000000000000000001
11111111111111111111